{
"items":["addball","small","large", "split","normal"],
"type" :{"normallife" : 1, "verystronglife" : 3,"stronglife" : 2,"normalx" : 1, "normaly" : 1, "strongx" : 1, "strongy" : 1, "verystrongx" : 1, "verystrongy" : 1 , "normaldropchance" : 5, "strongdropchance" : 10, "verystrongdropchance" : 25},
"bricks" : {"strong" : [332, 333, 334, 335, 336, 337, 338, 339, 340, 341, 342, 343, 344, 345, 346, 347, 348, 349, 350, 351, 352, 353, 354, 355, 356, 357, 358,
362, 363, 364, 365, 366, 367, 368, 369, 370, 371, 372, 373, 374, 375, 376, 377, 378, 379, 380, 381, 382, 383, 384, 385, 386, 387, 388,392, 393, 394, 395, 396, 
397, 398, 399, 400, 401, 402, 403, 404, 405, 406, 407, 408, 409, 410, 411, 412, 413, 414, 415, 416, 417, 418,422, 423, 424, 425, 426, 427, 428, 429, 430, 431, 
432, 433, 434, 435, 436, 437, 438, 439, 440, 441, 442, 443, 444, 445, 446, 447, 448,452, 453, 454, 455, 456, 457, 458, 459, 460, 461, 462, 463, 464, 465, 466, 
467, 468, 469, 470, 471, 472, 473, 474, 475, 476, 477, 478,482, 483, 484, 485, 486, 487, 488, 489, 490, 491, 492, 493, 494, 495, 496, 497, 498, 499, 500, 501, 
502, 503, 504, 505, 506, 507, 508,512, 513, 514, 515, 516, 517, 518, 519, 520, 521, 522, 523, 524, 525, 526, 527, 528, 529, 530, 531, 532, 533, 534, 535, 536
],

"verystrong" : [537, 538,542, 543, 544, 545, 546, 547, 548, 549, 550, 551, 552, 553, 554, 555, 556, 557, 558, 559, 560, 561, 562, 563, 564, 565, 566, 567, 568,572, 573, 574, 
575, 576, 577, 578, 579, 580, 581, 582, 583, 584, 585, 586, 587, 588, 589, 590, 591, 592, 593, 594, 595, 596, 597, 598,602, 603, 604, 605, 606, 607, 608, 609, 
610, 611, 612, 613, 614, 615, 616, 617, 618, 619, 620, 621, 622, 623, 624, 625, 626, 627, 628,193, 194, 195, 196, 197, 198,223, 224, 225, 226, 227, 228,253, 254, 
255, 256, 257, 258,283, 284, 285, 286, 287, 288,313, 314, 315, 316, 317, 318,235, 236, 237,265, 266, 267,295, 296, 297,325, 326, 327,213, 214,243, 244,273, 274,
303, 304,633, 634,663, 664,693, 694,723, 724,753, 754,783, 784,643, 644, 645, 646, 647, 648,673, 674, 675, 676, 677, 678,703, 704, 705, 706, 707, 708,635, 636, 637, 
638, 639, 640,665, 666, 667, 668
],
            
"normal" : [669, 670,73,103,133,163,78,108,138,168,143, 144,173, 174,203, 204,650, 651, 652, 653, 654, 655, 656, 657, 658,685, 686, 687, 688,715, 
716, 717, 718,746, 747,776, 777,806, 807,836, 837,734, 735, 736, 737,764, 765, 766, 767,795, 796,825, 826,855, 856,885, 886,154, 155, 156,184, 185, 186,785,815,845,875,
905,865, 866,895, 896,632,662,692,699,729,759,681,711,741,924,954,925,745,684,682,175,205,206,234, 324, 328, 112, 113, 167, 164,814,844,906,936,311, 312, 96,  97, 125,  
126, 215, 305, 302, 695, 698, 641
]}
}
