{
 "type" :{"normalx" : 1, "normaly" :1, "normaldropchance" : 4, "normallife" : 1},
 "items":["addball","small","split","powerball"],
"bricks" : {"normal" : [32,34,35,36,38,39,40,42,43,44,45,47,48,49,50,51,53,54,55,56,58,59,63,64,65,66,67,69,70,72,73,74,76,78,79,80,82,83,84,
85,86,87,88,92,93,94,95,96,97,98,99,100,101,102,103,104,105,106,107,108,109,110,111,112,113,114,115,116,117,118,119,123,124,125,126,127,128,129,130,131,132,133,135,
139,140,141,144,145,146,147,148,154,155,156,157,158,161,  162,  163,  164,  165,  166,  167,  168,  169,  170,  171,  172,  173,  174,  
175,  176,  177,  178,  179,  183,  184,  185,  186,  187,  188,  191,  192,  193,  194,  195,  197,  198,  200,  201,  203,  204,  205,  206,  
207,  208,  212,  213,  214,  215,  216,  217,  220,  221,  222,  223,  224,  225,  226,  227,  228,  229,  230,  231,  232,  233,  234,  236,  237,  238,  
239,  243, 246,  247,  248,  249,  250,  251,  252,  253,  254,  255,  256,  257,  258,  259,  260,  261 , 263,  264,  266,  267,  268,  272,  273,  276,  277,  278,  279,  280,  281,  282,  283,  284,  285,  286,  287,  288,  289,  290,  291,  293,  294,  295,  296,  297,  298,  299,  303,  304,  305,  306,  
307,  308,  309,  310,  311,  312,  313,  314,  315,  316,  317,  318,  319,  320,  321,  322,  323,  324,  325,  326,  327,  328,  333,  334,  335,  336,  337,  338,  
339,  342,  343,  344,  345,  346,  347,  348,  349,  350,  351,  352,  353,  354,  355,  356,  357,  358,  363,  364,  365,  366,  367,  368,  369,  
371,  372,  373,  374,  375,  376,  377,  378,  379,  380,  381,  382,  383,  384,  385,  386,  387,  392,  393,  394,  395,  399,  400,  401,  402,  
403,  404,  405,  406,  407,  408,  409,  410,  411,  412,  413,  414,  415,  416,  417,  418,  419,  423,  424,  425,  427,  428,  429,  430,  431,  432,  433,  434,  
435,  437,  438,  439,  440,  441,  442,  443,  444,  445,  446,  447,  448,  452,  453,  454,  456,  457,  459,  460,  462,  463,    466,  
467,  468,  469,  470,  471,  472,  473,  474,  475,  476,  477,  478,  479,  483,  484,  485,  486,  487,  488,  489,  490,  491,  492,  493,  494,  495,  496,  497,  498,  
499,  500,  501,  502,  503,  504,  505,  506,   512,  513,  514,  515,  516,  517,  518,  520,  521,  522,  524,  525,  526,  527,  528,  529,  530,  
531,  532,  533,  534,  535,  536,  537,  538,  539,  545,  546,  547,  548,  549,  550,  551,  552,  553,  554,  555,  557,  559,  560,  562,  
563,  564,  565,  566,  567,  568,  572,  573,  574,  576,  577,  578,  579,  580,  581,  584,  585,  586,  587,  588,  589,  590,  591,  592,  593,  594,  
595,  597,  604,  607,  608,  609,  610,  611,  612,  613,  614,  615,  616,  617,  618,  619,  621,  622,  623,  624,  625,  626,  627,
628,  632,  633,  634,  635,  636,  637,  638,  639,  640,   642,  643,  644,  645,  647,  649,  650,  651,  652,  654,  655,  657,  658,  659, 
663,  665,  666,  667,   669,  671,  672,  673,  674,  675,  676,   678,  679,  680,  682,  683,  684,  686,  687,  688, 692, 693,  694,  
695,  696,  697,  698,  699,  701,  702,  703,  705,  706,  707,  708,  709,  711 ,713, 714,  715,  716,  717,  718, 723, 724,    
727,  728,  729,  730,  731,  732,  733,  734,  735,  736,  737,  738,  739,  740,  741,  742,  743,  745,  746,  747,  748, 752, 753,  754,  755,  756,  758,  
759,  760,  761,   763,  765,  766,  767,  768,  769,  770,   772,  773,  774,  775,  776,  777,  778,  779,  783, 785,787,  788,  
791,  792,  793,  794,  795,  796,  797,  798,  799,  800,  801,  802,  803,  804,  806,  807,  808, 812, 813,  814,  815,  816,  817,  818,  819,  820,  821,  822,  
823,  824,  825,  826,  827,  829,  830,  831,  832,  833,  834,  835,  836,  838,  839, 843, 844 ,845, 846,  847 ,849  ,850, 851,  855 ,856,
857,  858,  860,  861,  862,  863,  864,  865,  866,  867,  868 ,872, 873,  874,  875,  876,  877,  878,  879 ,880  ,881,  883,  884,  885,  886,  887,  889,  
  891,  892,  894,  896,  897,  899
]}
}



