{
	"difficulty":"very easy",
	"fields":[
		[1,2,3,4,5,6,7,8,9],
		[4,5,6,7,8,9,1,2,3],
		[7,8,9,1,2,3,4,5,6],
		[2,3,1,5,6,4,8,9,7],
		[5,6,4,8,9,7,2,3,1],
		[8,9,7,2,3,1,5,6,4],
		[3,1,2,6,4,5,9,7,8],
		[6,4,5,9,7,8,3,1,2],
		[9,7,8,3,1,2,6,4,5]
		
	],
	"colors":[
		[0,0,0,1,1,1,1,2,2],
		[0,0,0,0,1,1,2,2,2],
		[3,0,0,1,1,1,2,2,2],
		[3,3,3,4,4,4,4,5,2],
		[3,3,3,3,4,5,5,5,5],
		[6,3,4,4,4,4,5,5,5],
		[6,6,6,7,7,7,8,8,5],
		[6,6,6,7,7,8,8,8,8],
		[6,6,7,7,7,7,8,8,8]


	],
	"empty":[
		[1,0,0,0,0,0,0,0,0],
		[1,0,0,0,1,0,1,1,1],	
		[0,0,1,0,0,0,1,1,1],	
		[0,0,0,1,0,0,0,0,0],	
		[1,1,0,0,1,1,0,0,0],	
		[0,0,0,1,0,1,0,1,0],	
		[1,1,0,0,1,0,0,1,1],	
		[1,1,1,0,1,1,0,1,1],	
		[1,1,0,0,0,0,0,1,0]
	]
}
