{
	"difficulty":"easy",
	"fields":[
		[8,3,4,2,7,6,1,9,5],
		[2,6,7,5,1,9,4,3,8],
		[9,4,5,3,8,7,2,1,6],
		[1,5,6,4,9,8,3,2,7],
		[4,8,9,7,3,2,6,5,1],
		[6,1,2,9,5,4,8,7,3],
		[5,9,1,8,4,3,7,6,2],
		[3,7,8,6,2,1,5,4,9],
		[7,2,3,1,6,5,9,8,4]		
	],
	"colors":[
		[0,0,0,0,0,0,0,1,1],
		[2,2,2,0,2,0,1,1,1],
		[2,2,2,2,2,3,3,1,1],
		[4,4,4,3,3,3,3,1,1],
		[4,4,4,4,4,4,3,3,3],
		[5,5,5,5,5,5,6,6,6],
		[7,7,7,5,7,5,5,6,6],
		[7,7,7,7,7,6,6,6,6],
		[8,8,8,8,8,8,8,8,8]	
	],
	"empty":[
		[1,0,0,0,0,0,0,0,0],
		[1,0,0,0,1,0,1,1,1],	
		[0,0,1,0,0,0,1,1,1],	
		[0,0,0,1,0,0,0,0,0],	
		[1,1,0,0,1,1,0,0,0],	
		[0,0,0,1,0,1,0,1,0],	
		[1,1,0,0,1,0,0,1,1],	
		[1,1,1,0,1,1,0,1,1],	
		[1,1,0,0,0,0,0,1,0]
	]
}
