{
	"difficulty":"moderate",
	"fields":[
		[4,5,6,7,8,9,1,2,3],
		[7,8,9,1,2,3,4,5,6],
		[2,3,1,4,5,6,8,9,7],
		[5,6,4,8,9,7,2,3,1],
		[8,9,7,2,3,1,5,6,4],
		[3,1,2,5,6,4,9,7,8],
		[6,4,5,9,7,8,3,1,2],
		[9,7,8,3,1,2,6,4,5],
		[3,1,2,6,4,5,9,7,8]
		
	],
	"colors":[
		[0,0,0,1,1,1,1,1,1],
		[0,0,0,0,0,0,1,1,1],
		[3,3,3,3,3,3,3,3,3],
		[4,5,5,5,6,6,7,8,8],
		[4,5,5,5,6,6,7,8,8],
		[4,5,5,5,6,6,7,8,8],
		[4,4,2,2,2,6,7,7,8],
		[4,4,2,2,2,6,7,7,8],
		[4,4,2,2,2,6,7,7,8]
	],
	"empty":[
		[1,0,0,0,0,0,0,0,0],
		[1,0,0,0,1,0,1,1,1],	
		[0,0,1,0,0,0,1,1,1],	
		[0,0,0,1,0,0,0,0,0],	
		[1,1,0,0,1,1,0,0,0],	
		[0,0,0,1,0,1,0,1,0],	
		[1,1,0,0,1,0,0,1,1],	
		[1,1,1,0,1,1,0,1,1],	
		[1,1,0,0,0,0,0,1,0]
	]
}
